MAPS MUST BE SQUARE! THAT IS WIDTH == HEIGHT

width:10
height:10
tilewidth:32
tileheight:32

0,0,0,0,0,0,0,0,0,0
0,1,1,1,1,1,1,1,1,0
0,1,1,1,1,1,1,1,1,0
0,1,1,0,0,0,0,1,1,0
0,1,1,0,0,0,0,1,1,0
0,1,1,0,0,0,0,1,1,0
0,1,1,0,0,0,0,1,1,0
0,2,2,0,0,0,0,3,3,0
0,2,2,0,0,0,0,3,3,0
0,0,0,0,0,0,0,0,0,0